|############################|
|#............##............#|
|#.####.#####.##.#####.####.#|
|#o####.#####.##.#####.####o#|
|#.####.#####.##.#####.####.#|
|#..........................#|
|#.####.##.########.##.####.#|
|#.####.##.########.##.####.#|
|#......##....##....##......#|
|######.##### ## #####.######|
|     #.##### ## #####.#     |
|     #.##          ##.#     |
|     #.## ###WW### ##.#     |
|######.## #      # ##.######|
|0     .   #      #   .     0|
|######.## #      # ##.######|
|     #.## ######## ##.#     |
|     #.##    FF    ##.#     |
|     #.## ######## ##.#     |
|######.## ######## ##.######|
|#............##............#|
|#.####.#####.##.#####.####.#|
|#.####.#####.##.#####.####.#|
|#o..##.......fP.......##..o#|
|###.##.##.########.##.##.###|
|###.##.##.########.##.##.###|
|#......##....##....##......#|
|#.##########.##.##########.#|
|#.##########.##.##########.#|
|#..........................#|
|############################|
$
