|                            |
|############################|
|#............##............#|
|#.####.#####.##.#####.####.#|
|#o####.#####.##.#####.####o#|
|#.####.#####.##.#####.####.#|
|#..........................#|
|#.####.##.########.##.####.#|
|#.####.##.########.##.####.#|
|#......##....##....##......#|
|######.##### ## #####.######|
|     #.##### ## #####.#     |
|     #.##          ##.#     |
|     #.## ###WW### ##.#     |
|######.## #      # ##.######|
|1     .   #      #   .     0|
|######.## #      # ##.######|
|     #.## ######## ##.#     |
|     #.##    FF    ##.#     |
|     #.## ######## ##.#     |
|######.## ######## ##.######|
|#............##............#|
|#.####.#####.##.#####.####.#|
|#.####.#####.##.#####.####.#|
|0 ..  .......fP.......  .. 1|
|###.#####.########.##.##.###|
|###.#####.########.##.##.###|
|#...##2##....##....##2##...#|
|#.#### #####.##.##########.#|
|#.#### #####.##.##########.#|
|#..........................#|
|############################|
|                            |
$
